10 10
##########
#s.......#
##.#.###.#
##.#...#.#
####.###.#
##.....#.#
######.#.#
###....###
#...##..g#
##########
