11 11
###########
#s........#
####.####.#
####.####.#
#....####.#
#.##......#
#.#########
#......####
#.##.#.####
#....#...g#
###########
